####################
#X      O..........#
#******..**********#
#*******.*.........#
#..................#
#..................E
####################
