##############
#I. *..**.#  G
#.. ......#  #
#** .*.*..#  #
#.* ......#  #
#P. ..*...#  #
#   *..*..#  #
#*...*...*#  #
#..*....*.#  #
#.*...*..*#  #
#...*..*..#  #
#*...*..*.#  #
#.*..*...*   #
##############