####################
#I      P..........#
#******..**********#
#*******.*.........#
#..................#
#..................G
####################
