#############
#I..*..**.#.G
#.........#.#
#**..*.*..#.#
#.........#.#
#P*...*...#.#
#...*..*..#.#
#*...*...*#.#
#..*....*.#.#
#.*...*..*#.#
#...*..*..#.#
#*...*..*.#.#
#.*..*...*..#
#############